"File names","CT num","DT num","RT num","AC num","DC num","CC num","RC num",SMO's_Total
"Weberp-3.0-demo_mod_sort.sql to Weberp-3.01-demo_mod_sort.sql",0,0,0,0,0,1,0,1
"Weberp-3.01-demo_mod_sort.sql to Weberp-3.02-demo_mod_sort.sql",8,1,0,6,5,0,0,20
"Weberp-3.02-demo_mod_sort.sql to Weberp-3.03-demo_mod_sort.sql",0,0,0,21,1,9,0,31
"Weberp-3.03-demo_mod_sort.sql to Weberp-3.04-demo_mod_sort.sql",0,0,0,0,0,1,0,1
"Weberp-3.04-demo_mod_sort.sql to Weberp-3.05-demo_mod_sort.sql",3,0,0,1,0,0,0,4
"Weberp-3.05-demo_mod_sort.sql to Weberp-3.06-demo_mod_sort.sql",3,1,0,3,0,0,0,7
"Weberp-3.06-demo_mod_sort.sql to Weberp-3.07-demo_mod_sort.sql",2,0,0,0,0,0,0,2
"Weberp-3.07-demo_mod_sort.sql to Weberp-3.08-demo_mod_sort.sql",0,0,0,3,0,0,0,3
"Weberp-3.08-demo_mod_sort.sql to Weberp-3.09-demo_mod_sort.sql",3,0,0,6,0,2,0,11
"Weberp-3.09-demo_mod_sort.sql to Weberp-3.10-demo_mod_sort.sql",6,0,0,8,0,3,0,17
"Weberp-3.10-demo_mod_sort.sql to Weberp-3.11-demo_mod_sort.sql",6,0,0,31,0,3,0,40
"Weberp-3.11-demo_mod_sort.sql to Weberp-3.11.1-demo_mod_sort.sql",0,0,0,0,0,0,0,0
"Weberp-3.11.1-demo_mod_sort.sql to Weberp-4.00-demo_mod_sort.sql",15,0,0,60,27,14,0,116
"Weberp-4.00-demo_mod_sort.sql to Weberp-4.04-demo_mod_sort.sql",0,0,0,0,0,0,0,0
"Weberp-4.04-demo_mod_sort.sql to Weberp-4.04.1-demo_mod_sort.sql",0,0,0,1,0,1,0,2
"Weberp-4.04.1-demo_mod_sort.sql to Weberp-4.04.4-demo_mod_sort.sql",0,0,0,1,0,0,0,1
"Weberp-4.04.4-demo_mod_sort.sql to Weberp-4.04.5-demo_mod_sort.sql",0,0,0,1,0,0,0,1
"Weberp-4.04.5-demo_mod_sort.sql to Weberp-4.05-demo_mod_sort.sql",0,0,0,0,0,0,0,0
"Weberp-4.05-demo_mod_sort.sql to Weberp-4.06-demo_mod_sort.sql",0,0,0,2,1,0,0,3
"Weberp-4.06-demo_mod_sort.sql to Weberp-4.07-demo_mod_sort.sql",3,0,0,1,0,0,0,4
"Weberp-4.07-demo_mod_sort.sql to Weberp-4.08-demo_mod_sort.sql",5,0,0,2,0,11,0,18
"Weberp-4.08-demo_mod_sort.sql to Weberp-4.09-demo_mod_sort.sql",1,0,0,2,0,5,0,8
"Weberp-4.09-demo_mod_sort.sql to Weberp-4.10-demo_mod_sort.sql",2,0,0,3,2,2,0,9
"Weberp-4.10-demo_mod_sort.sql to Weberp-4.11-demo_mod_sort.sql",6,0,0,9,1,31,0,47
"Weberp-4.11-demo_mod_sort.sql to Weberp-4.11.2-demo_mod_sort.sql",1,0,0,1,0,1,0,3
"Weberp-4.11.2-demo_mod_sort.sql to Weberp-4.11.3-demo_mod_sort.sql",1,0,0,1,0,2,0,4
"Weberp-4.11.3-demo_mod_sort.sql to Weberp-4.11.4-demo_mod_sort.sql",3,0,0,8,0,4,0,15
"Weberp-4.11.4-demo_mod_sort.sql to Weberp-4.12-demo_mod_sort.sql",4,0,0,3,0,1,0,8
"Weberp-4.12-demo_mod_sort.sql to Weberp-4.12.1-demo_mod_sort.sql",0,0,0,0,0,0,0,0
"Weberp-4.12.1-demo_mod_sort.sql to Weberp-4.12.2-demo_mod_sort.sql",0,0,0,0,0,1,0,1
"Weberp-4.12.2-demo_mod_sort.sql to Weberp-4.12.3-demo_mod_sort.sql",0,0,0,2,0,0,0,2
"Weberp-4.12.3-demo_mod_sort.sql to Weberp-4.13-demo_mod_sort.sql",3,0,0,4,0,2,0,9
"Weberp-4.13-demo_mod_sort.sql to Weberp-4.13.1-demo_mod_sort.sql",0,0,0,4,0,1,0,5
"Weberp-4.13.1-demo_mod_sort.sql to Weberp-4.14-demo_mod_sort.sql",1,0,0,3,0,0,0,4
"Weberp-4.14-demo_mod_sort.sql to Weberp-4.14.1-demo_mod_sort.sql",0,0,0,0,0,0,0,0
"Weberp-4.14.1-demo_mod_sort.sql to Weberp-4.15-demo_mod_sort.sql",5,0,0,11,0,3,0,19
"Weberp-4.15-demo_mod_sort.sql to Weberp-4.15.1-demo_mod_sort.sql",4,0,0,2,1,55,0,62
"Weberp-4.15.1-demo_mod_sort.sql to Weberp-4.15.2-demo_mod_sort.sql",0,0,0,1,0,0,0,1
